31 30 30 31 39 30 30 38 30 30 30 31 30 38 30 30 30 30 38 30 30 39 30 30 39 30 31 30 38 30 31 30 30 31 30 30 39 31 30 31 30 31 39 30 38 39 30 30 30 31 30 31 30 30 31 39 30 31 30 31 39 31 30 30 31 31 39 30 30 31 30 31 38 31 39
30 31 31 30 38 30 30 30 30 39 30 30 30 30 31 39 30 31 30 39 31 38 31 30 38 31 39 31 30 31 39 31 30 39 30 39 38 30 31 30 39 30 38 31 31 38 31 39 31 31 39 31 31 31 30 38 39 30 31 31 38 30 31 31 39 30 38 39 30 31 39 30 31 30 38
30 31 30 31 31 30 30 30 39 38 31 30 39 30 30 38 30 39 30 38 30 30 39 30 31 30 38 30 31 30 38 30 30 38 30 38 31 30 39 30 38 31 31 31 30 31 30 38 30 31 38 30 31 30 31 30 38 31 39 30 30 39 30 30 38 31 31 38 31 39 38 30 31 31 30
30 39 30 39 30 30 30 30 38 30 39 30 38 30 39 30 30 38 30 30 30 39 38 31 30 39 30 31 30 39 30 31 30 31 30 31 31 30 38 31 31 30 31 30 39 31 31 30 39 31 30 30 39 30 39 31 30 31 38 31 31 38 31 31 30 31 30 30 31 38 30 31 39 30 31
31 38 30 38 31 30 39 30 31 30 38 30 30 30 38 30 30 30 31 31 39 38 31 30 31 38 30 31 30 38 30 39 31 31 39 30 30 39 30 31 30 31 39 30 38 31 31 30 38 30 31 31 38 31 38 31 31 30 30 31 30 30 31 30 31 39 31 31 39 30 30 30 38 31 31
30 30 30 30 30 39 38 31 30 39 30 30 39 30 31 39 30 30 39 30 38 30 31 39 30 31 31 39 31 30 31 38 39 31 38 31 39 38 31 30 39 30 38 31 31 30 39 31 30 31 39 31 30 31 30 30 39 31 31 39 31 30 30 39 30 38 31 30 38 31 31 30 39 30 39
39 31 31 30 31 38 31 30 30 38 30 30 38 31 30 38 30 31 38 30 31 31 30 38 30 30 31 38 30 31 30 30 38 30 31 30 38 30 31 30 38 31 31 30 31 30 38 30 31 31 38 30 31 30 31 31 38 31 30 38 31 31 31 38 31 30 30 39 30 30 39 31 38 31 38
38 31 30 31 31 30 30 20 20 20 20 20 20 20 20 20 20 20 20 20 20 20 20 20 20 20 20 20 20 20 20 20 20 20 20 20 20 20 20 20 20 20 20 20 20 20 20 20 20 20 20 20 20 20 20 20 20 20 20 20 20 20 20 20 20 20 20 38 30 31 38 30 31 30 30
31 30 39 30 31 31 39 20 31 31 30 30 20 20 20 20 30 31 30 31 31 20 20 20 20 20 20 20 20 20 20 20 20 20 20 20 31 20 20 20 20 20 20 20 20 20 30 20 20 20 20 20 31 30 31 20 20 20 20 20 20 20 20 20 20 20 20 30 39 31 30 31 30 39 31
30 31 38 31 30 30 38 20 30 30 30 31 31 30 31 30 31 20 20 20 30 31 30 30 31 30 30 31 31 30 30 30 31 30 31 30 31 20 31 30 30 31 30 31 30 20 31 20 30 30 31 30 30 20 30 20 31 30 31 20 30 30 31 30 31 30 20 31 38 30 31 39 31 38 31
30 30 31 30 39 30 30 20 30 31 30 30 20 20 20 20 20 20 20 20 20 20 20 20 20 20 20 30 20 20 31 20 20 20 20 20 20 20 31 20 20 20 20 20 30 20 31 20 31 20 20 20 20 20 30 20 30 20 30 20 31 20 20 20 20 31 20 31 30 31 31 38 30 31 30
39 31 31 30 38 31 30 20 30 30 31 20 20 31 31 30 30 30 31 30 31 30 30 31 31 30 30 31 20 30 30 20 31 30 31 30 31 30 31 20 31 30 31 30 31 20 30 20 31 30 31 30 30 20 30 31 30 20 31 20 31 20 30 31 30 30 20 31 31 39 30 30 39 30 30
38 30 30 30 31 30 39 20 20 20 20 20 20 31 20 20 20 20 20 20 20 20 20 20 20 20 20 20 20 31 20 20 31 20 20 20 20 20 20 20 31 20 20 20 20 20 30 20 20 20 20 20 31 20 31 20 20 20 30 20 30 20 31 20 20 31 20 30 30 38 31 30 38 31 39
31 31 39 31 31 31 38 20 31 31 30 31 30 30 20 31 30 30 31 31 30 30 31 30 20 30 30 30 31 31 20 20 30 20 20 31 30 31 31 20 30 30 31 31 30 20 31 31 31 30 30 31 30 20 31 20 30 31 31 20 30 20 30 20 30 31 20 39 31 30 30 39 30 31 38
31 30 38 31 39 30 31 20 31 20 20 20 20 20 20 31 20 20 20 20 20 20 20 31 20 31 20 20 20 31 30 31 30 20 20 31 20 20 30 20 20 20 20 20 30 20 20 30 20 20 20 20 20 20 30 20 31 20 20 20 30 20 31 20 31 20 20 38 30 39 31 38 30 30 31
30 31 30 30 38 31 30 20 31 30 30 31 20 20 20 30 20 31 30 31 31 30 20 30 30 31 20 30 30 31 20 20 20 20 20 30 20 20 31 31 30 30 31 30 31 31 20 30 20 31 30 30 30 31 30 20 31 30 31 30 31 20 30 20 30 20 20 31 31 38 31 30 31 31 30
39 31 30 31 30 39 31 20 20 20 20 31 20 31 31 30 20 20 20 20 20 30 20 20 20 20 20 31 20 30 20 31 30 31 30 31 31 20 20 20 20 30 20 20 20 20 20 31 20 31 20 20 20 20 20 20 20 20 20 20 20 20 30 20 31 20 20 31 30 31 30 31 39 30 30
38 30 31 39 31 38 30 20 31 30 31 30 20 30 20 31 30 30 31 30 31 31 20 31 31 30 20 31 20 31 20 30 20 20 30 20 30 20 20 20 20 20 20 31 30 31 30 31 20 30 20 31 31 30 30 31 30 31 30 30 31 31 30 31 31 31 20 30 39 30 31 30 38 30 31
30 30 31 38 31 30 31 20 30 20 20 20 20 30 20 20 20 20 20 20 20 20 20 30 20 31 20 30 20 30 20 20 20 20 31 20 31 30 31 31 31 30 30 31 20 20 20 20 20 30 20 31 20 20 20 20 20 20 20 20 20 20 31 20 30 20 20 30 38 30 31 30 30 31 39
30 39 30 31 30 31 31 20 30 20 20 20 20 31 20 30 31 30 31 30 30 31 31 30 20 30 20 30 20 31 20 30 20 20 31 20 20 20 20 20 20 20 20 30 20 30 30 30 31 31 20 30 30 31 30 31 30 31 30 30 30 31 31 20 31 30 20 31 30 31 30 39 30 31 38
30 38 31 30 31 30 30 20 31 30 31 31 20 30 30 31 20 20 20 20 20 20 20 20 20 30 20 30 20 30 20 31 31 30 31 30 31 30 30 31 31 30 20 20 20 31 20 20 20 20 20 31 20 20 20 20 20 20 20 20 20 20 20 20 20 30 20 31 30 39 31 38 31 30 31
39 31 31 30 31 30 39 20 20 20 20 31 20 20 20 20 20 31 31 30 30 31 30 30 31 31 20 31 20 30 20 20 20 20 20 20 20 20 20 20 20 30 20 31 30 31 20 30 30 31 20 30 30 31 31 30 30 30 31 31 20 30 31 31 30 31 20 39 31 38 30 30 30 31 30
38 31 30 31 30 31 38 20 20 30 20 30 20 31 30 30 31 30 20 20 20 20 20 20 20 20 20 30 20 31 20 31 30 30 30 31 30 31 30 30 31 31 20 30 20 20 20 31 20 31 20 20 20 20 20 20 20 20 20 30 20 31 20 20 20 20 20 38 30 31 31 30 31 39 30
31 30 39 30 30 31 30 20 20 31 20 30 20 31 20 20 20 20 20 31 30 30 31 31 30 30 31 31 20 31 20 31 20 20 20 20 20 20 20 20 20 31 20 31 20 30 20 30 20 30 30 30 31 31 30 30 31 30 20 30 20 30 30 31 31 20 20 30 30 39 30 31 30 38 31
31 30 38 31 30 39 31 20 20 30 20 31 20 31 20 30 31 30 30 31 20 20 20 20 20 20 20 20 20 30 20 31 20 30 30 31 31 30 30 31 20 31 20 30 20 31 20 30 20 20 20 20 20 20 20 20 20 31 20 30 20 20 20 20 30 20 20 30 31 38 31 30 31 30 31
30 31 31 30 31 38 31 20 20 30 30 31 20 30 20 20 20 20 31 20 20 31 30 30 31 31 30 30 31 30 20 30 20 31 20 20 20 20 20 20 20 30 20 30 20 31 20 30 20 31 31 30 30 31 31 30 30 31 20 31 31 30 30 20 30 20 20 39 31 30 31 39 30 31 30
30 30 31 39 30 30 30 20 30 31 20 20 20 30 30 31 31 20 30 20 30 30 20 20 31 20 20 20 20 20 20 30 20 30 20 20 20 31 30 30 31 30 20 31 20 30 20 31 20 30 20 20 20 20 20 20 20 20 20 20 20 20 30 20 31 20 20 38 30 31 30 38 30 31 39
39 31 30 38 30 30 31 20 20 31 20 20 20 20 20 20 30 20 30 20 31 20 20 20 30 20 31 31 30 30 31 31 20 31 30 31 20 31 20 20 20 20 20 31 20 30 20 30 20 30 31 30 31 30 30 31 30 30 31 31 30 30 31 20 30 20 20 30 31 30 31 30 31 31 38
38 31 30 30 31 31 31 20 31 30 30 31 31 31 30 20 30 20 31 20 30 30 30 20 31 20 30 20 20 20 20 20 20 20 20 31 20 30 31 30 30 31 30 30 20 31 20 30 20 20 20 20 20 20 20 20 31 20 20 20 20 20 31 20 30 31 20 30 31 39 30 30 30 30 31
30 30 31 30 30 30 31 20 31 20 30 20 20 30 20 20 31 20 31 20 20 20 31 20 30 20 31 30 30 31 30 31 30 31 20 30 20 30 20 20 20 20 20 30 20 30 20 30 20 30 30 30 31 31 30 30 31 20 30 20 20 20 20 20 20 30 20 31 30 38 39 31 39 31 30
31 39 31 30 31 31 30 20 30 20 31 20 20 31 30 30 31 20 30 30 31 30 31 20 30 20 20 20 20 20 20 30 20 31 20 30 20 31 20 30 31 31 20 31 20 30 20 31 20 31 20 20 20 20 20 20 20 20 31 31 30 30 31 30 30 31 20 31 30 31 38 30 38 30 30
31 38 31 39 31 31 30 20 30 20 30 20 20 20 20 20 30 20 20 20 20 20 20 20 31 20 20 20 20 20 20 31 20 30 20 30 20 30 31 30 20 30 20 31 20 31 30 31 20 31 30 30 31 30 30 31 30 20 31 20 31 20 20 20 20 20 20 39 31 31 30 31 30 31 31
30 30 30 38 30 39 31 20 31 20 30 20 30 31 31 30 30 20 31 30 30 31 31 20 31 30 30 30 31 31 20 30 20 30 20 31 20 20 20 20 20 30 20 30 20 20 20 20 20 20 20 20 20 20 20 20 20 20 30 20 30 20 30 31 30 30 20 38 30 30 39 30 31 39 30
30 31 31 31 30 38 31 20 20 20 31 20 31 20 20 20 31 20 31 20 20 20 30 20 20 20 20 20 20 31 20 30 20 30 20 31 30 30 31 31 20 30 20 30 20 31 31 30 30 31 31 30 30 30 31 31 20 30 30 20 31 20 30 20 20 20 20 30 39 31 38 31 31 38 30
31 31 39 31 30 31 39 20 20 30 31 20 31 20 20 30 30 20 30 31 31 20 30 20 30 30 31 30 30 30 20 31 20 31 20 20 20 20 20 30 20 30 20 30 20 31 20 20 20 20 20 20 20 20 20 30 20 31 20 20 30 20 31 30 30 31 20 31 38 30 31 30 30 31 31
39 30 38 30 31 30 38 20 20 31 20 20 30 30 20 31 20 20 20 20 30 20 31 20 31 20 20 20 20 20 20 31 30 31 31 30 30 31 20 30 20 31 20 30 20 30 20 31 30 31 30 30 31 20 30 30 20 30 31 20 30 20 20 20 20 30 20 30 31 31 30 31 39 31 30
38 31 30 31 31 39 30 20 20 30 20 20 20 31 20 30 31 30 30 20 30 20 31 20 31 30 31 30 30 30 20 20 20 20 20 20 20 30 20 31 20 31 20 31 20 30 20 30 20 20 20 20 31 20 31 20 20 20 30 20 31 31 30 30 31 31 20 31 30 30 31 30 38 30 39
30 31 30 39 31 38 30 20 31 30 31 31 20 31 20 20 20 20 31 20 31 20 30 20 30 20 20 20 20 31 20 30 31 31 30 30 31 31 30 30 20 30 20 31 20 31 20 30 20 31 30 31 30 20 31 20 30 20 31 20 20 20 20 20 20 20 20 31 31 30 39 31 31 30 38
30 30 31 38 30 30 31 20 31 20 20 30 20 30 20 31 30 30 31 20 30 20 30 20 30 31 30 31 20 31 20 20 20 20 20 20 20 31 20 20 20 20 20 30 20 31 20 20 20 31 20 31 20 20 30 30 31 20 30 31 30 30 31 30 30 30 20 30 31 31 38 30 30 31 31
30 39 31 30 31 30 31 20 30 31 20 30 20 31 20 30 20 20 20 20 30 20 30 20 20 20 20 20 20 30 20 31 30 30 31 31 30 30 20 30 31 31 30 30 20 30 30 31 20 30 20 30 20 20 30 20 20 20 20 20 20 20 20 20 20 31 20 39 30 31 30 31 31 30 31
31 38 30 31 39 30 30 20 20 20 20 30 20 30 20 30 31 30 30 31 31 20 31 20 30 30 31 31 30 30 20 31 20 20 20 20 20 20 20 20 20 20 20 20 20 20 20 30 20 30 20 30 20 20 31 20 30 31 30 31 30 31 31 30 30 31 20 38 39 30 31 30 39 31 30
31 31 30 31 38 31 30 20 30 31 20 31 20 31 20 20 20 20 20 20 20 20 31 20 30 20 20 20 20 20 20 30 20 30 31 31 30 31 30 20 31 30 30 30 31 31 20 31 30 31 20 31 30 20 31 20 31 20 30 20 20 20 20 20 20 20 20 30 38 31 30 31 38 30 31
30 31 31 30 31 31 39 20 20 31 20 31 20 31 20 31 31 30 30 31 30 31 30 20 31 20 30 31 30 30 31 30 20 30 20 30 20 20 20 20 31 20 20 20 20 30 20 20 20 20 20 20 20 20 30 20 30 20 31 31 30 31 30 30 31 30 20 31 30 31 31 39 30 31 31
39 30 31 31 30 30 38 20 30 30 20 30 20 30 20 30 20 20 20 20 20 20 30 20 31 20 30 20 20 20 20 20 20 31 20 30 20 30 30 31 30 20 31 30 31 30 30 31 30 31 30 30 31 30 31 20 30 20 30 20 20 20 20 20 20 31 20 30 31 30 31 38 31 30 31
38 31 30 30 31 31 30 20 30 20 20 30 20 30 20 30 20 31 30 30 30 31 31 20 30 20 31 20 30 30 31 31 30 30 20 31 20 31 20 31 20 20 30 20 30 20 20 30 20 20 20 20 20 20 20 20 31 20 30 20 31 30 30 31 30 30 20 39 30 39 30 31 30 39 30
31 30 39 30 31 30 31 20 31 31 30 31 20 30 20 31 20 31 20 20 20 20 20 20 30 20 30 20 31 20 20 31 20 20 20 30 20 31 20 30 20 31 30 20 30 20 31 31 30 30 30 20 30 31 30 30 31 20 31 20 30 20 20 20 20 20 20 38 31 38 31 30 31 38 31
31 31 38 31 39 30 31 20 20 20 20 20 20 31 20 31 20 30 30 30 20 31 30 31 31 20 31 30 30 30 20 30 20 31 30 30 31 30 20 30 20 31 20 20 30 20 30 20 20 20 20 20 31 20 20 20 20 20 31 20 31 30 30 31 30 31 20 30 31 30 31 30 31 31 30
30 30 31 30 38 30 31 20 30 30 31 30 31 31 20 30 20 30 20 20 20 30 20 30 20 20 20 20 20 30 20 30 20 30 20 20 30 20 20 30 20 30 20 20 31 20 30 30 30 30 30 20 30 20 31 30 31 30 30 20 20 20 20 20 20 30 20 30 30 30 39 31 30 30 31
31 30 31 30 31 31 30 20 31 20 30 20 20 30 20 30 20 31 31 30 30 31 20 30 20 31 31 30 30 31 20 31 20 30 20 20 31 31 20 31 20 30 20 30 31 20 31 20 20 20 20 20 30 20 31 20 20 20 20 20 31 30 30 31 31 30 20 31 30 31 38 30 39 31 30
31 30 39 31 30 30 39 20 31 20 30 20 31 30 20 30 20 20 20 20 20 20 20 31 20 30 20 20 20 20 20 31 20 31 20 20 20 30 20 31 20 30 20 30 20 20 30 31 30 31 31 20 31 20 30 30 31 31 30 20 30 20 20 20 20 20 20 30 39 31 30 30 38 31 30
30 31 38 31 30 31 38 20 30 20 30 20 30 20 20 31 20 20 31 31 30 30 31 30 20 30 31 30 30 30 20 30 20 30 31 30 20 30 20 30 20 31 20 31 20 20 20 20 20 20 30 20 31 20 20 20 20 20 31 20 31 20 30 31 30 20 20 31 38 30 39 30 30 31 39
39 31 30 30 39 31 30 20 30 20 31 20 30 20 30 30 31 30 30 20 20 20 30 20 20 20 20 20 20 31 20 20 20 20 30 20 20 30 20 30 20 31 20 30 31 31 31 30 30 31 30 20 30 20 30 31 31 30 30 20 30 20 30 20 30 20 20 31 30 31 38 30 31 30 38
38 30 31 30 38 30 30 20 20 20 31 20 31 20 20 31 20 20 30 20 20 20 31 20 31 31 30 30 20 30 31 30 31 20 30 20 20 31 20 31 20 30 20 20 30 20 30 20 31 20 31 20 30 20 30 20 20 20 20 20 30 20 31 20 31 20 20 30 31 30 30 39 31 30 30
30 39 31 30 30 31 39 20 31 30 30 20 31 30 20 31 20 20 31 31 30 20 30 20 30 20 20 31 20 20 31 20 30 20 31 30 30 31 20 30 31 30 31 31 30 20 31 20 30 30 31 20 30 20 31 20 31 31 31 20 31 20 31 20 31 20 20 39 31 30 31 38 30 30 31
31 38 30 31 39 30 38 20 20 20 20 20 20 30 20 30 20 20 20 20 30 20 30 20 30 20 20 30 20 20 30 20 30 20 20 20 20 20 20 20 20 20 20 20 20 20 20 20 20 20 20 20 31 20 31 20 30 20 30 20 30 20 30 20 30 20 20 38 30 39 30 30 31 39 31
30 31 30 31 38 31 30 20 31 30 30 30 20 31 20 30 31 31 30 20 31 20 31 20 31 31 20 31 30 31 30 20 31 31 30 30 30 31 31 30 30 30 31 31 30 30 31 30 31 31 30 30 31 20 30 20 31 20 31 20 31 20 20 20 30 20 20 31 31 38 31 31 30 38 30
30 31 30 31 30 31 31 20 30 20 30 20 20 31 20 20 20 20 30 20 30 20 31 20 20 30 20 20 20 20 20 20 20 20 20 20 20 20 20 20 20 20 20 20 30 20 31 20 20 20 20 20 20 20 30 20 30 20 30 20 30 31 30 30 31 20 20 31 30 31 30 31 31 30 30
30 30 30 31 30 39 30 20 30 20 20 20 20 31 30 30 20 20 31 20 30 20 30 30 31 30 20 31 30 31 30 30 31 31 30 30 31 20 30 30 31 20 31 20 31 20 30 20 30 20 31 31 30 20 31 20 30 20 30 20 20 20 20 20 20 20 20 30 31 30 39 30 30 31 39
39 31 31 39 30 38 31 20 31 30 31 30 30 31 20 31 20 20 30 20 31 20 20 20 20 30 20 31 20 20 20 20 20 20 20 20 31 20 30 20 31 20 30 20 30 20 30 20 30 20 30 20 30 20 30 20 30 20 31 30 31 30 30 31 31 30 20 39 31 30 38 31 39 30 38
38 31 30 38 30 31 30 20 31 20 20 20 20 20 20 31 30 30 31 20 30 30 31 31 20 31 20 30 31 30 30 31 31 30 30 20 30 20 31 20 30 20 30 31 31 20 31 31 30 20 31 20 31 20 31 20 31 20 20 20 20 20 20 30 20 20 20 38 30 31 30 31 38 30 30
31 30 30 30 31 30 30 20 30 31 30 30 31 20 20 20 20 20 20 20 20 20 20 30 20 31 20 20 20 20 20 20 20 20 30 20 30 20 31 20 30 20 20 20 20 20 20 20 20 20 30 20 31 30 30 20 31 30 31 30 30 31 20 30 20 31 20 30 30 31 30 30 30 30 30
30 31 39 31 30 30 39 20 31 20 20 20 30 20 31 30 30 31 20 31 31 30 20 31 20 30 20 20 20 20 30 31 31 20 31 20 30 20 30 20 31 30 30 31 30 31 30 30 31 31 30 20 20 20 20 20 20 20 20 20 20 31 20 31 20 31 20 30 39 30 30 31 31 30 31
31 30 38 31 30 31 38 20 20 20 20 20 20 20 30 20 20 31 20 30 20 31 20 30 20 30 31 31 30 20 30 20 30 20 31 20 31 20 31 20 20 20 20 20 20 20 20 20 20 20 20 20 20 20 20 31 31 30 30 31 20 30 20 30 20 30 20 31 38 30 30 39 31 30 30
30 31 30 30 31 39 30 20 31 30 30 30 30 31 31 20 30 30 20 31 20 30 20 20 20 20 30 20 30 20 31 20 30 20 30 20 31 20 30 31 30 30 31 20 30 31 30 20 31 30 30 31 31 30 20 30 20 20 20 31 20 30 20 31 20 30 20 31 30 30 39 38 30 30 31
30 31 31 30 31 38 31 20 30 30 31 31 30 30 31 20 31 20 20 30 20 30 31 30 30 20 31 30 31 20 30 20 30 20 30 20 30 20 20 20 20 20 30 20 31 20 31 20 31 20 20 20 20 30 20 30 20 20 20 30 20 31 20 30 20 30 20 30 31 30 38 30 30 31 39
39 30 31 31 39 30 30 20 31 30 30 30 30 30 30 20 30 20 20 30 20 20 31 20 30 20 20 20 20 20 30 20 31 20 31 20 30 31 30 30 31 20 30 20 30 20 31 20 30 31 30 31 20 31 31 30 30 31 20 30 20 31 20 30 20 31 20 30 31 31 30 30 30 31 38
38 31 39 31 38 30 39 20 30 31 30 30 31 30 30 20 31 30 30 31 20 20 30 30 31 31 30 30 30 31 31 20 30 31 30 20 20 20 20 20 31 30 31 30 31 20 30 31 30 20 20 20 20 20 20 20 20 31 20 31 30 30 20 31 30 31 20 31 30 30 30 31 39 30 30
30 30 38 30 30 30 38 20 20 20 20 20 20 20 20 20 20 20 20 20 20 20 20 20 20 20 20 20 20 20 20 20 20 20 20 20 20 20 20 20 20 20 20 20 20 20 20 20 20 20 20 20 20 20 20 20 20 20 20 20 20 20 20 20 20 20 20 39 31 39 31 30 38 30 31
30 31 30 30 39 30 31 30 30 31 30 31 30 31 30 31 30 31 30 31 30 39 30 31 30 30 30 30 31 30 31 30 30 30 31 31 30 30 31 31 31 31 30 31 39 30 31 31 30 31 31 30 39 30 31 31 30 31 30 30 39 30 31 39 30 30 30 38 31 38 31 31 30 30 31
30 31 31 30 38 30 31 30 30 39 31 30 30 31 30 39 30 30 31 31 31 38 39 31 31 30 39 31 30 31 31 39 31 31 30 30 39 31 30 30 30 31 39 31 38 31 30 39 31 30 30 31 38 31 30 30 30 39 31 31 38 31 30 38 30 31 31 31 30 30 30 30 31 31 30
30 30 30 30 30 31 30 31 39 38 31 30 39 31 31 38 31 39 30 30 30 30 38 30 30 31 38 31 30 30 30 38 31 30 31 30 38 30 31 30 31 30 38 30 31 30 31 38 30 31 39 31 30 30 31 30 31 38 30 31 30 30 39 30 31 39 31 30 39 31 31 39 30 31 39
31 39 30 39 31 30 31 30 38 30 39 31 38 30 39 31 30 38 31 39 31 30 30 39 30 31 30 30 39 31 30 31 30 30 39 31 30 30 39 30 31 30 30 39 31 30 31 30 31 31 38 30 31 39 30 39 31 30 30 30 31 30 38 30 30 38 30 31 38 31 30 38 30 30 38
31 38 30 38 30 31 39 30 30 31 38 30 30 30 38 31 30 30 31 38 39 31 30 38 31 30 39 31 38 30 31 31 39 30 38 31 30 31 38 31 30 39 30 38 30 39 31 30 39 30 30 30 30 38 31 38 30 31 39 30 30 31 30 30 31 31 30 30 31 30 31 30 31 30 30
30 31 31 31 31 39 38 31 31 39 30 31 39 30 30 39 31 30 39 30 38 31 30 30 30 31 38 30 31 30 31 30 38 30 30 30 31 30 31 30 31 38 30 30 31 38 30 31 38 31 31 39 31 30 31 30 31 30 38 31 39 30 31 30 30 31 30 39 31 30 30 31 39 31 30
30 31 30 31 30 38 30 31 30 38 30 31 38 30 30 38 31 31 38 30 30 30 31 31 30 31 31 30 31 39 30 31 30 31 31 39 31 31 30 39 31 30 31 31 30 31 31 30 31 30 30 38 30 31 39 30 30 31 30 31 38 30 31 30 39 30 31 38 30 31 31 30 38 30 39