20 20 20 20 20 20 20 20 20 20 20 20 20 20 20 20 20 20 20 20 20 20 20 20 20 20 20 20 20 20 20 20 20 20 20 20 20 20 20 20 20 20 20 20 20 20 20 20 20 20 20 20 20 20 20 20 20 20 20 20 20 20 20 20 20 20 20 20 20 20 20 20 20 20 20
20 20 20 20 20 20 20 20 20 20 20 20 20 20 20 20 20 20 20 20 20 20 20 20 20 20 20 20 20 20 20 20 20 20 20 20 20 20 20 20 20 20 20 20 20 20 20 20 20 20 20 20 20 20 20 20 20 20 20 20 20 20 20 20 20 20 20 20 20 20 20 20 20 20 20
20 20 20 20 20 20 20 20 20 20 20 20 20 20 20 20 20 20 20 20 20 20 20 20 20 20 20 20 20 20 20 20 20 20 20 20 20 20 20 20 20 20 20 20 20 20 20 20 20 20 20 20 20 20 20 20 20 20 20 20 20 20 20 20 20 20 20 20 20 20 20 20 20 20 20
20 20 20 20 20 20 20 20 20 20 20 20 20 20 20 20 20 20 20 20 20 20 20 20 20 20 20 20 20 20 20 20 20 20 20 20 20 20 20 20 20 20 20 20 20 20 20 20 20 20 20 20 20 20 20 20 20 20 20 20 20 20 20 20 20 20 20 20 20 20 20 20 20 20 20
20 20 20 20 20 20 20 20 20 20 20 20 20 20 20 20 20 20 20 20 20 20 20 20 20 20 20 20 20 20 20 20 20 20 20 20 20 20 20 20 20 20 20 20 20 20 20 20 20 20 20 20 20 20 20 20 20 20 20 20 20 20 20 20 20 20 20 20 20 20 20 20 20 20 20
20 20 20 20 20 20 20 20 20 20 20 20 20 20 20 20 20 20 20 20 20 20 20 20 20 20 20 20 20 20 20 20 20 20 20 20 20 20 20 20 20 20 20 20 20 20 20 20 20 20 20 20 20 20 20 20 20 20 20 20 20 20 20 20 20 20 20 20 20 20 20 20 20 20 20
20 20 20 20 20 20 20 20 20 20 20 20 20 20 20 20 20 20 20 20 20 20 20 20 20 20 20 20 20 20 20 20 20 20 20 20 20 20 20 20 20 20 20 20 20 20 20 20 20 20 20 20 20 20 20 20 20 20 20 20 20 20 20 20 20 20 20 20 20 20 20 20 20 20 20
20 20 20 20 20 20 20 20 20 20 20 20 20 20 20 20 20 20 20 20 20 20 20 20 20 20 20 20 20 20 20 20 20 20 20 20 20 20 20 20 20 20 20 20 20 20 20 20 20 20 20 20 20 20 20 20 20 20 20 20 20 20 20 20 20 20 20 20 20 20 20 20 20 20 20
20 20 20 20 20 20 20 20 20 20 20 20 20 20 20 20 20 20 20 20 20 20 20 20 20 20 20 20 20 20 20 20 20 20 20 20 20 20 20 20 20 20 20 20 20 20 20 20 20 20 20 20 20 20 20 20 20 20 20 20 20 20 20 20 20 20 20 20 20 20 20 20 20 20 20
20 20 20 20 20 20 20 20 20 20 20 20 20 20 20 20 20 20 20 20 20 20 20 20 20 20 20 20 20 20 20 20 20 20 20 20 20 20 20 20 20 20 20 20 20 20 20 20 20 20 20 20 30 30 30 30 30 30 20 20 20 20 20 20 20 20 20 20 20 20 20 20 20 20 20
20 20 20 20 20 20 20 20 20 20 20 20 20 20 20 20 20 20 20 20 20 20 20 20 20 20 20 20 20 20 20 20 20 20 20 20 20 20 20 20 20 20 20 20 20 20 20 20 20 30 30 30 30 11 12 12 13 30 30 30 30 20 20 20 20 20 20 20 20 20 20 20 20 20 20
20 20 20 20 20 20 20 20 20 20 20 20 20 20 20 20 20 20 20 20 20 20 20 20 20 20 20 20 20 20 20 20 20 20 20 20 20 20 20 20 20 20 20 20 20 20 20 20 30 30 11 12 12 39 15 15 38 12 12 13 30 30 20 20 20 20 20 20 20 20 20 20 20 20 20
20 20 20 20 20 20 20 20 20 20 20 20 20 20 20 20 20 20 20 20 20 20 20 20 20 20 20 20 20 20 20 20 20 20 20 20 20 20 20 20 20 20 20 20 20 20 20 30 30 11 39 15 15 15 15 15 15 15 15 38 13 30 30 20 20 20 20 20 20 20 20 20 20 20 20
20 20 20 20 20 20 20 20 20 20 20 20 20 20 20 30 30 30 30 30 30 30 30 30 30 20 20 20 20 20 20 20 20 20 20 20 20 20 20 20 20 20 20 20 20 20 30 30 11 39 15 15 15 15 15 15 15 15 15 15 38 13 30 30 20 20 20 20 20 20 20 20 20 20 20
20 20 20 20 20 20 20 20 20 20 20 20 20 20 30 30 11 12 12 12 12 12 12 13 30 30 20 20 20 20 20 20 20 20 20 20 20 20 20 20 20 20 20 20 20 30 30 11 39 15 15 15 15 15 15 15 15 15 15 15 15 38 13 30 30 20 20 20 20 20 20 20 20 20 20
20 20 20 20 20 20 20 20 20 20 20 20 20 30 30 11 39 15 15 15 15 15 15 38 13 30 30 20 20 20 20 20 20 20 20 20 20 20 20 20 20 20 20 20 20 30 11 39 15 15 15 15 15 15 15 15 15 15 15 15 15 15 38 13 30 20 20 20 20 20 20 20 20 20 20
20 20 20 20 20 20 20 20 20 20 20 20 20 30 11 39 15 15 15 15 15 15 15 15 38 13 30 20 20 20 20 20 20 20 20 20 20 20 20 20 20 20 20 20 20 30 14 15 15 15 15 15 15 15 15 15 15 15 15 15 15 15 15 16 30 20 20 20 20 20 20 20 20 20 20
20 20 20 20 20 20 20 20 20 20 20 20 20 30 14 15 15 15 15 15 15 15 15 15 15 16 30 20 20 20 20 20 20 20 20 20 20 20 20 20 20 20 20 20 30 30 14 15 15 15 15 15 15 15 15 15 15 15 15 15 15 15 15 16 30 30 20 20 20 20 20 20 20 20 20
20 20 20 20 20 20 20 20 20 20 20 20 20 30 14 15 15 15 15 15 15 15 15 15 15 16 30 30 30 30 30 30 30 30 30 30 30 30 30 30 30 30 30 30 30 11 39 15 15 15 15 15 15 15 15 15 15 15 15 15 15 15 15 38 13 30 20 20 20 20 20 20 20 20 20
20 20 20 20 20 20 20 20 20 20 20 20 20 30 14 15 15 15 15 15 15 15 15 15 15 38 12 12 12 12 12 12 12 12 12 12 12 12 12 12 12 12 12 12 12 39 15 15 15 15 15 15 15 15 15 15 15 15 15 15 15 15 15 15 16 30 20 20 20 20 20 20 20 20 20
20 20 20 20 20 20 20 20 20 20 20 20 20 30 14 15 15 15 15 15 15 15 15 15 15 36 18 18 18 18 18 18 18 18 18 18 18 18 18 18 18 18 18 18 18 37 15 15 15 15 15 15 15 15 15 15 15 15 15 15 15 15 15 15 16 30 20 20 20 20 20 20 20 20 20
20 20 20 20 20 20 20 20 20 20 20 20 20 30 14 15 15 15 15 15 15 15 15 15 15 16 30 30 30 30 30 30 30 30 30 30 30 30 30 30 30 30 30 30 30 17 37 15 15 15 15 15 15 15 15 15 15 15 15 15 15 15 15 36 19 30 20 20 20 20 20 20 20 20 20
20 20 20 20 20 20 20 20 20 20 20 20 20 30 14 15 15 15 15 15 15 15 15 15 15 16 30 20 20 20 20 20 20 20 20 20 20 20 20 20 20 20 20 20 30 30 14 15 15 15 15 15 15 15 15 15 15 15 15 15 15 15 15 16 30 30 20 20 20 20 20 20 20 20 20
20 20 20 20 20 20 20 20 20 20 20 20 20 30 17 37 15 15 15 15 15 15 15 15 36 19 30 20 21 22 22 22 22 22 22 22 22 22 22 22 22 22 23 20 20 30 14 15 15 15 15 15 15 15 15 15 15 15 15 15 15 15 15 16 30 20 20 20 20 20 20 20 20 20 20
20 20 20 20 20 20 20 20 20 20 20 20 20 30 30 17 37 15 15 15 15 15 15 36 19 30 30 20 24 25 25 25 25 25 25 25 25 25 25 25 25 25 34 23 20 30 17 37 15 15 15 15 15 15 15 15 15 15 15 15 15 15 36 19 30 20 20 20 20 20 20 20 20 20 20
20 20 20 20 20 20 20 20 20 20 20 20 20 20 30 30 17 18 18 37 36 18 18 19 30 30 20 21 35 25 25 25 25 25 25 25 25 25 25 25 25 25 25 26 20 30 30 17 37 15 15 15 15 15 15 15 15 15 15 15 15 36 19 30 30 20 20 20 20 20 20 20 20 20 20
20 20 20 20 20 20 20 20 20 20 20 20 20 20 20 30 30 30 30 14 16 30 30 30 30 20 21 35 25 25 25 25 25 25 25 25 25 25 25 25 25 25 25 34 23 20 30 30 17 37 15 15 15 15 15 15 15 15 15 15 36 19 30 30 20 20 20 20 20 20 20 20 20 20 20
20 20 20 20 20 20 20 20 20 20 20 20 20 20 20 20 20 20 30 14 16 30 20 20 20 21 35 25 25 25 25 25 25 25 25 25 25 25 25 25 25 25 25 25 26 20 20 30 30 17 37 15 15 15 15 15 15 15 15 36 19 30 30 20 20 20 20 20 20 20 20 20 20 20 20
20 20 20 20 20 20 20 20 20 20 20 20 20 20 20 20 20 20 30 14 16 30 20 20 21 35 25 25 25 25 25 25 25 25 25 25 25 25 25 25 25 25 25 25 34 23 20 20 30 30 17 18 18 37 15 15 36 18 18 19 30 30 20 20 20 20 20 20 20 20 20 20 20 20 20
20 20 20 20 20 20 20 20 20 20 20 20 20 20 20 20 20 20 30 14 16 30 20 20 24 25 25 25 25 25 25 25 25 25 25 25 25 25 25 25 25 25 25 25 25 34 23 20 20 30 30 30 30 17 37 36 19 30 30 30 30 20 20 20 20 20 20 20 20 20 20 20 20 20 20
20 20 20 20 20 20 20 20 20 20 20 20 20 20 20 20 20 20 30 14 16 30 20 20 24 25 25 25 25 25 25 25 25 25 25 25 25 25 25 25 25 25 25 25 25 25 34 23 20 20 20 20 30 30 14 16 30 30 20 20 20 20 20 20 20 20 20 20 20 20 20 20 20 20 20
20 20 20 20 20 20 20 20 20 20 20 20 20 20 20 20 20 20 30 14 16 30 20 20 27 33 25 25 25 25 25 25 25 25 25 25 25 25 25 25 25 25 25 25 25 25 25 34 22 23 20 20 20 30 14 16 30 20 20 20 20 20 20 20 20 20 20 20 20 20 20 20 20 20 20
20 20 20 20 20 20 20 20 20 20 20 20 20 20 20 20 20 30 30 14 16 30 30 20 20 27 33 25 25 25 25 25 25 25 25 25 25 25 25 25 25 25 25 25 25 25 25 25 25 34 22 23 20 30 14 16 30 20 20 20 20 20 20 20 20 20 20 20 20 20 20 20 20 20 20
22 22 23 20 20 20 20 20 20 20 20 20 20 20 20 20 30 30 11 39 38 13 30 30 20 20 24 25 25 25 25 25 25 25 25 25 25 25 25 25 25 25 25 25 25 25 25 25 25 25 25 26 20 30 14 16 30 20 20 20 20 20 20 20 20 20 20 20 20 20 20 20 20 20 20
25 25 26 20 20 20 20 20 20 20 20 20 20 20 20 30 30 11 39 15 15 38 13 30 30 20 24 25 25 25 25 25 25 25 25 25 25 25 25 25 25 25 25 25 25 25 25 25 25 25 25 26 20 30 14 16 30 20 20 20 20 20 20 20 20 20 20 20 20 20 20 20 20 20 20
25 25 34 23 20 20 20 20 20 20 20 20 20 20 20 30 11 39 15 15 15 15 38 13 30 20 27 33 25 25 25 25 25 25 25 25 25 25 25 25 25 25 25 25 25 25 25 25 25 25 25 26 20 30 14 16 30 20 20 20 20 20 20 20 20 20 20 20 20 20 20 20 20 20 20
25 25 25 34 22 22 22 22 23 20 20 20 20 20 20 30 14 15 15 15 15 15 15 16 30 20 20 24 25 25 25 25 25 25 25 25 25 25 25 25 25 25 25 25 25 25 25 25 25 25 25 26 20 30 14 16 30 20 20 20 20 20 20 20 20 20 20 20 20 20 20 20 20 20 20
25 25 25 25 25 25 25 25 34 22 23 20 20 20 20 30 14 15 15 15 15 15 15 16 30 20 20 24 25 25 25 25 25 25 25 25 25 25 25 25 25 25 25 25 25 25 25 25 25 25 25 26 20 30 14 16 30 20 20 20 20 20 20 20 20 20 20 20 20 20 20 20 20 20 20
25 25 25 25 25 25 25 25 25 25 34 23 20 20 20 30 17 37 15 15 15 15 36 19 30 20 20 24 25 25 25 25 25 25 25 25 25 25 25 25 25 25 25 25 25 25 25 25 25 25 25 26 20 30 14 16 30 20 20 20 20 20 20 20 20 20 20 20 20 20 20 20 20 20 20
25 25 25 25 25 25 25 25 25 25 25 34 22 23 20 30 30 17 37 15 15 36 19 30 30 20 21 35 25 25 25 25 25 25 25 25 25 25 25 25 25 25 25 25 25 25 25 25 25 25 25 26 20 30 14 16 30 20 20 20 20 20 20 20 20 20 20 20 20 20 20 20 20 20 20
25 25 25 25 25 25 25 25 25 25 25 25 25 34 23 20 30 30 17 18 18 19 30 30 20 20 24 25 25 25 25 25 25 25 25 25 25 25 25 25 25 25 25 25 25 25 25 25 25 25 25 26 20 30 14 16 30 20 20 20 20 20 20 20 20 20 20 20 20 20 20 20 20 20 20
25 25 25 25 25 25 25 25 25 25 25 25 25 25 34 23 30 30 30 30 30 30 30 20 20 21 35 25 25 25 25 25 25 25 25 25 25 25 25 25 25 25 25 25 25 25 25 25 25 25 25 26 20 30 14 16 30 20 20 20 20 20 20 20 20 20 20 20 20 20 20 20 20 20 20
25 25 25 25 25 25 25 25 25 25 25 25 25 25 25 34 22 22 22 22 22 22 22 22 22 35 25 25 25 25 25 25 25 25 25 25 25 25 25 25 25 25 25 25 25 25 25 25 25 25 25 26 20 30 14 16 30 20 20 20 20 20 20 20 20 20 20 20 20 20 20 20 20 20 20
25 25 25 25 25 25 25 25 25 25 25 25 25 32 28 28 28 28 28 28 28 28 28 28 28 28 28 33 25 25 25 25 25 25 25 25 25 25 25 25 25 25 25 25 25 25 25 25 25 32 28 29 20 30 14 16 30 20 20 20 20 20 20 20 20 20 20 20 20 20 20 20 20 20 20
25 25 25 25 25 25 25 25 32 28 28 28 28 29 20 30 30 30 30 30 30 30 30 30 30 30 30 27 28 28 33 25 25 25 25 25 25 25 25 25 25 25 25 25 25 25 25 32 28 29 20 20 30 30 14 16 30 30 20 20 20 20 20 20 20 20 20 20 20 20 20 20 20 20 20
25 25 25 25 25 25 25 32 29 20 20 20 20 30 30 30 11 12 12 12 12 12 12 12 12 13 30 30 30 20 27 33 25 25 25 25 25 25 25 25 25 25 25 25 25 25 32 29 20 30 30 30 30 11 39 38 13 30 30 30 30 20 20 20 20 20 20 20 20 20 20 20 20 20 20
25 25 25 25 25 25 32 29 20 20 20 20 30 30 11 12 39 15 15 15 15 15 15 15 15 38 12 13 30 30 20 27 33 25 25 25 25 25 25 25 25 25 25 25 25 32 29 20 30 30 11 12 12 39 15 15 38 12 12 13 30 30 20 20 20 20 20 20 20 20 20 20 20 20 20
25 25 25 25 25 32 29 20 20 20 20 30 30 11 39 15 15 15 15 15 15 15 15 15 15 15 15 38 13 30 30 20 24 25 25 25 25 25 25 25 25 25 25 25 25 26 20 30 30 11 39 15 15 15 15 15 15 15 15 38 13 30 30 20 20 20 20 20 20 20 20 20 20 20 20
25 25 25 32 28 29 20 20 20 20 20 30 11 39 15 15 15 15 15 15 15 15 15 15 15 15 15 15 38 13 30 20 27 33 25 25 25 25 25 25 25 25 25 25 32 29 30 30 11 39 15 15 15 15 15 15 15 15 15 15 38 13 30 30 20 20 20 20 20 20 20 20 20 20 20
28 28 28 29 20 20 20 20 20 20 30 30 14 15 15 15 15 15 15 15 15 15 15 15 15 15 15 15 15 16 30 30 20 27 33 25 25 25 25 25 25 25 25 25 26 30 30 11 39 15 15 15 15 15 15 15 15 15 15 15 15 38 13 30 30 20 20 20 20 20 20 20 20 20 20
20 20 20 20 20 20 20 20 20 20 30 11 39 15 15 15 15 15 15 15 15 15 15 15 15 15 15 15 15 38 13 30 20 20 24 25 25 25 25 25 25 25 25 32 29 30 11 39 15 15 15 15 15 15 15 15 15 15 15 15 15 15 38 13 30 20 20 20 20 20 20 20 20 20 20
20 20 20 20 20 20 20 20 20 20 30 14 15 15 15 15 15 15 15 15 15 15 15 15 15 15 15 15 15 15 16 30 20 20 27 33 25 25 25 25 25 25 25 26 20 30 14 15 15 15 15 15 15 15 15 15 15 15 15 15 15 15 15 16 30 20 20 20 20 20 20 20 20 20 20
20 20 20 20 20 20 20 20 20 20 30 14 15 15 15 15 15 15 15 15 15 15 15 15 15 15 15 15 15 15 16 30 20 20 20 27 28 28 28 28 28 28 28 29 30 30 14 15 15 15 15 15 15 15 15 15 15 15 15 15 15 15 15 16 30 30 20 20 20 20 20 20 20 20 20
20 20 20 20 20 20 20 20 20 20 30 14 15 15 15 15 15 15 15 15 15 15 15 15 15 15 15 15 15 15 16 30 30 30 30 30 30 30 30 30 30 30 30 30 30 11 39 15 15 15 15 15 15 15 15 15 15 15 15 15 15 15 15 38 13 30 20 20 20 20 20 20 20 20 20
20 20 20 20 20 20 20 20 20 20 30 14 15 15 15 15 15 15 15 15 15 15 15 15 15 15 15 15 15 15 38 12 12 12 12 12 12 12 12 12 12 12 12 12 12 39 15 15 15 15 15 15 15 15 15 15 15 15 15 15 15 15 15 15 16 30 20 20 20 20 20 20 20 20 20
20 20 20 20 20 20 20 20 20 20 30 14 15 15 15 15 15 15 15 15 15 15 15 15 15 15 15 15 15 15 36 18 18 18 18 18 18 18 18 18 18 18 18 18 18 37 15 15 15 15 15 15 15 15 15 15 15 15 15 15 15 15 15 15 16 30 20 20 20 20 20 20 20 20 20
20 20 20 20 20 20 20 20 20 20 30 14 15 15 15 15 15 15 15 15 15 15 15 15 15 15 15 15 15 15 16 30 30 30 30 30 30 30 30 30 30 30 30 30 30 17 37 15 15 15 15 15 15 15 15 15 15 15 15 15 15 15 15 36 19 30 20 20 20 20 20 20 20 20 20
20 20 20 20 20 20 20 20 20 20 30 14 15 15 15 15 15 15 15 15 15 15 15 15 15 15 15 15 15 15 16 30 20 20 20 20 20 20 20 20 20 20 20 20 30 30 14 15 15 15 15 15 15 15 15 15 15 15 15 15 15 15 15 16 30 30 20 20 20 20 20 20 20 20 20
20 20 20 20 20 20 20 20 20 20 30 14 15 15 15 15 15 15 15 15 15 15 15 15 15 15 15 15 15 15 16 30 20 20 20 20 20 20 20 20 20 20 20 20 20 30 14 15 15 15 15 15 15 15 15 15 15 15 15 15 15 15 15 16 30 20 20 20 20 20 20 20 20 20 20
20 20 20 20 20 20 20 20 20 20 30 17 37 15 15 15 15 15 15 15 15 15 15 15 15 15 15 15 15 36 19 30 20 20 20 20 20 20 20 20 20 20 20 20 20 30 17 37 15 15 15 15 15 15 15 15 15 15 15 15 15 15 36 19 30 20 20 20 20 20 20 20 20 20 20
20 20 20 20 20 20 20 20 20 20 30 30 14 15 15 15 15 15 15 15 15 15 15 15 15 15 15 15 15 16 30 30 20 20 20 20 20 20 20 20 20 20 20 20 20 30 30 17 37 15 15 15 15 15 15 15 15 15 15 15 15 36 19 30 30 20 20 20 20 20 20 20 20 20 20
20 20 20 20 20 20 20 20 20 20 20 30 17 37 15 15 15 15 15 15 15 15 15 15 15 15 15 15 36 19 30 20 20 20 20 20 20 20 20 20 20 20 20 20 20 20 30 30 17 37 15 15 15 15 15 15 15 15 15 15 36 19 30 30 20 20 20 20 20 20 20 20 20 20 20
20 20 20 20 20 20 20 20 20 20 20 30 30 17 37 15 15 15 15 15 15 15 15 15 15 15 15 36 19 30 30 20 20 20 20 20 20 20 20 20 20 20 20 20 20 20 20 30 30 17 37 15 15 15 15 15 15 15 15 36 19 30 30 20 20 20 20 20 20 20 20 20 20 20 20
20 20 20 20 20 20 20 20 20 20 20 20 30 30 17 18 37 15 15 15 15 15 15 15 15 36 18 19 30 30 20 20 20 20 20 20 20 20 20 20 20 20 20 20 20 20 20 20 30 30 17 18 18 37 15 15 36 18 18 19 30 30 20 20 20 20 20 20 20 20 20 20 20 20 20
20 20 20 20 20 20 20 20 20 20 20 20 20 30 30 30 17 18 18 18 18 18 18 18 18 19 30 30 30 20 20 20 20 20 20 20 20 20 20 20 20 20 20 20 20 20 20 20 20 30 30 30 30 17 18 18 19 30 30 30 30 20 20 20 20 20 20 20 20 20 20 20 20 20 20
20 20 20 20 20 20 20 20 20 20 20 20 20 20 20 30 30 30 30 30 30 30 30 30 30 30 30 20 20 20 20 20 20 20 20 20 20 20 20 20 20 20 20 20 20 20 20 20 20 20 20 20 30 30 30 30 30 30 20 20 20 20 20 20 20 20 20 20 20 20 20 20 20 20 20
20 20 20 20 20 20 20 20 20 20 20 20 20 20 20 20 20 20 20 20 20 20 20 20 20 20 20 20 20 20 20 20 20 20 20 20 20 20 20 20 20 20 20 20 20 20 20 20 20 20 20 20 20 20 20 20 20 20 20 20 20 20 20 20 20 20 20 20 20 20 20 20 20 20 20
20 20 20 20 20 20 20 20 20 20 20 20 20 20 20 20 20 20 20 20 20 20 20 20 20 20 20 20 20 20 20 20 20 20 20 20 20 20 20 20 20 20 20 20 20 20 20 20 20 20 20 20 20 20 20 20 20 20 20 20 20 20 20 20 20 20 20 20 20 20 20 20 20 20 20
20 20 20 20 20 20 20 20 20 20 20 20 20 20 20 20 20 20 20 20 20 20 20 20 20 20 20 20 20 20 20 20 20 20 20 20 20 20 20 20 20 20 20 20 20 20 20 20 20 20 20 20 20 20 20 20 20 20 20 20 20 20 20 20 20 20 20 20 20 20 20 20 20 20 20
20 20 20 20 20 20 20 20 20 20 20 20 20 20 20 20 20 20 20 20 20 20 20 20 20 20 20 20 20 20 20 20 20 20 20 20 20 20 20 20 20 20 20 20 20 20 20 20 20 20 20 20 20 20 20 20 20 20 20 20 20 20 20 20 20 20 20 20 20 20 20 20 20 20 20
20 20 20 20 20 20 20 20 20 20 20 20 20 20 20 20 20 20 20 20 20 20 20 20 20 20 20 20 20 20 20 20 20 20 20 20 20 20 20 20 20 20 20 20 20 20 20 20 20 20 20 20 20 20 20 20 20 20 20 20 20 20 20 20 20 20 20 20 20 20 20 20 20 20 20
20 20 20 20 20 20 20 20 20 20 20 20 20 20 20 20 20 20 20 20 20 20 20 20 20 20 20 20 20 20 20 20 20 20 20 20 20 20 20 20 20 20 20 20 20 20 20 20 20 20 20 20 20 20 20 20 20 20 20 20 20 20 20 20 20 20 20 20 20 20 20 20 20 20 20
20 20 20 20 20 20 20 20 20 20 20 20 20 20 20 20 20 20 20 20 20 20 20 20 20 20 20 20 20 20 20 20 20 20 20 20 20 20 20 20 20 20 20 20 20 20 20 20 20 20 20 20 20 20 20 20 20 20 20 20 20 20 20 20 20 20 20 20 20 20 20 20 20 20 20
20 20 20 20 20 20 20 20 20 20 20 20 20 20 20 20 20 20 20 20 20 20 20 20 20 20 20 20 20 20 20 20 20 20 20 20 20 20 20 20 20 20 20 20 20 20 20 20 20 20 20 20 20 20 20 20 20 20 20 20 20 20 20 20 20 20 20 20 20 20 20 20 20 20 20
20 20 20 20 20 20 20 20 20 20 20 20 20 20 20 20 20 20 20 20 20 20 20 20 20 20 20 20 20 20 20 20 20 20 20 20 20 20 20 20 20 20 20 20 20 20 20 20 20 20 20 20 20 20 20 20 20 20 20 20 20 20 20 20 20 20 20 20 20 20 20 20 20 20 20