30 30 30 30 30 30 30 30 30 30 30 30 30 30 30 30 30 30 30 30 30 30 30 30 30 30 30 30 30 30 30 30 30 30 30 30 30 30 30 30 30 30 30 30 30 30 30 30 30 30 30 30 30 30 30 30 30 30 30 30 30 30 30 30 30 30 30 30 30 30 30 30 30 30 30
30 30 30 30 30 30 30 30 30 30 30 30 30 30 30 30 30 30 30 30 30 30 30 30 30 30 30 30 30 30 30 30 30 30 30 30 30 30 30 30 30 30 30 30 30 30 30 30 30 30 30 30 30 30 30 30 30 30 30 30 30 30 30 30 30 30 30 30 30 30 30 30 30 30 30
30 30 30 30 30 30 30 30 30 30 30 30 30 30 30 30 30 30 30 30 30 30 30 30 30 30 30 30 30 30 30 30 30 30 30 30 30 30 30 30 30 30 30 30 30 30 30 30 30 30 30 30 30 30 30 30 30 30 30 30 30 30 30 30 30 30 30 30 30 30 30 30 30 30 30
30 30 30 30 30 30 30 30 30 30 30 30 30 30 30 30 30 30 30 30 30 30 30 30 30 30 30 30 30 30 30 30 30 30 30 30 30 30 30 30 30 30 30 30 30 30 30 30 30 30 30 30 30 30 30 30 30 30 30 30 30 30 30 30 30 30 30 30 30 30 30 30 30 30 30
30 30 30 30 30 30 30 30 30 30 30 30 30 30 30 30 30 30 30 30 30 30 30 30 30 30 30 30 30 30 30 30 30 30 30 30 30 30 30 30 30 30 30 30 30 30 30 30 30 30 30 30 30 30 30 30 30 30 30 30 30 30 30 30 30 30 30 30 30 30 30 30 30 30 30
30 30 30 30 30 30 30 30 30 30 30 30 30 30 30 30 30 30 30 30 30 30 30 30 30 30 30 30 30 30 30 30 30 30 30 30 30 30 30 30 30 30 30 30 30 30 30 30 30 30 30 30 30 30 30 30 30 30 30 30 30 30 30 30 30 30 30 30 30 30 30 30 30 30 30
30 30 30 30 30 30 30 30 30 30 30 30 30 30 30 30 30 30 30 30 30 30 30 30 30 30 30 30 30 30 30 30 30 30 30 30 30 30 30 30 30 30 30 30 30 30 30 30 30 30 30 30 30 30 30 30 30 30 30 30 30 30 30 30 30 30 30 30 30 30 30 30 30 30 30
30 30 30 30 30 30 30 20 20 20 20 20 20 20 20 20 20 20 20 20 20 20 20 20 20 20 20 20 20 20 20 20 20 20 20 20 20 20 20 20 20 20 20 20 20 20 20 20 20 20 20 20 20 20 20 20 20 20 20 20 20 20 20 20 20 20 20 30 30 30 30 30 30 30 30
30 30 30 30 30 30 30 20 31 31 30 30 20 20 20 20 30 31 30 31 31 20 20 20 20 20 20 20 20 20 20 20 20 20 20 20 31 20 20 20 20 20 20 20 20 20 30 20 20 20 20 20 31 30 31 20 20 20 20 20 20 20 20 20 20 20 20 30 30 30 30 30 30 30 30
30 30 30 30 30 30 30 20 30 30 30 31 31 30 31 30 31 20 20 20 30 31 30 30 31 30 30 31 31 30 30 30 31 30 31 30 31 20 31 30 30 31 30 31 30 20 31 20 30 30 31 30 30 20 30 20 31 30 31 20 30 30 31 30 31 30 20 30 30 30 30 30 30 30 30
30 30 30 30 30 30 30 20 30 31 30 30 20 20 20 20 20 20 20 20 20 20 20 20 20 20 20 30 20 20 31 20 20 20 20 20 20 20 31 20 20 20 20 20 30 20 31 20 31 20 20 20 20 20 30 20 30 20 30 20 31 20 20 20 20 31 20 30 30 30 30 30 30 30 30
30 30 30 30 30 30 30 20 30 30 31 20 20 31 31 30 30 30 31 30 31 30 30 31 31 30 30 31 20 30 30 20 31 30 31 30 31 30 31 20 31 30 31 30 31 20 30 20 31 30 31 30 30 20 30 31 30 20 31 20 31 20 30 31 30 30 20 30 30 30 30 30 30 30 30
30 30 30 30 30 30 30 20 20 20 20 20 20 31 20 20 20 20 20 20 20 20 20 20 20 20 20 20 20 31 20 20 31 20 20 20 20 20 20 20 31 20 20 20 20 20 30 20 20 20 20 20 31 20 31 20 20 20 30 20 30 20 31 20 20 31 20 30 30 30 30 30 30 30 30
30 30 30 30 30 30 30 20 31 31 30 31 30 30 20 31 30 30 31 31 30 30 31 30 20 30 30 30 31 31 20 20 30 20 20 31 30 31 31 20 30 30 31 31 30 20 31 31 31 30 30 31 30 20 31 20 30 31 31 20 30 20 30 20 30 31 20 30 30 30 30 30 30 30 30
30 30 30 30 30 30 30 20 31 20 20 20 20 20 20 31 20 20 20 20 20 20 20 31 20 31 20 20 20 31 30 31 30 20 20 31 20 20 30 20 20 20 20 20 30 20 20 30 20 20 20 20 20 20 30 20 31 20 20 20 30 20 31 20 31 20 20 30 30 30 30 30 30 30 30
30 30 30 30 30 30 30 20 31 30 30 31 20 20 20 30 20 31 30 31 31 30 20 30 30 31 20 30 30 31 20 20 20 20 20 30 20 20 31 31 30 30 31 30 31 31 20 30 20 31 30 30 30 31 30 20 31 30 31 30 31 20 30 20 30 20 20 30 30 30 30 30 30 30 30
30 30 30 30 30 30 30 20 20 20 20 31 20 31 31 30 20 20 20 20 20 30 20 20 20 20 20 31 20 30 20 31 30 31 30 31 31 20 20 20 20 30 20 20 20 20 20 31 20 31 20 20 20 20 20 20 20 20 20 20 20 20 30 20 31 20 20 30 30 30 30 30 30 30 30
30 30 30 30 30 30 30 20 31 30 31 30 20 30 20 31 30 30 31 30 31 31 20 31 31 30 20 31 20 31 20 30 20 20 30 20 30 20 20 20 20 20 20 31 30 31 30 31 20 30 20 31 31 30 30 31 30 31 30 30 31 31 30 31 31 31 20 30 30 30 30 30 30 30 30
30 30 30 30 30 30 30 20 30 20 20 20 20 30 20 20 20 20 20 20 20 20 20 30 20 31 20 30 20 30 20 20 20 20 31 20 31 30 31 31 31 30 30 31 20 20 20 20 20 30 20 31 20 20 20 20 20 20 20 20 20 20 31 20 30 20 20 30 30 30 30 30 30 30 30
30 30 30 30 30 30 30 20 30 20 20 20 20 31 20 30 31 30 31 30 30 31 31 30 20 30 20 30 20 31 20 30 20 20 31 20 20 20 20 20 20 20 20 30 20 30 30 30 31 31 20 30 30 31 30 31 30 31 30 30 30 31 31 20 31 30 20 30 30 30 30 30 30 30 30
30 30 30 30 30 30 30 20 31 30 31 31 20 30 30 31 20 20 20 20 20 20 20 20 20 30 20 30 20 30 20 31 31 30 31 30 31 30 30 31 31 30 20 20 20 31 20 20 20 20 20 31 20 20 20 20 20 20 20 20 20 20 20 20 20 30 20 30 30 30 30 30 30 30 30
30 30 30 30 30 30 30 20 20 20 20 31 20 20 20 20 20 31 31 30 30 31 30 30 31 31 20 31 20 30 20 20 20 20 20 20 20 20 20 20 20 30 20 31 30 31 20 30 30 31 20 30 30 31 31 30 30 30 31 31 20 30 31 31 30 31 20 30 30 30 30 30 30 30 30
30 30 30 30 30 30 30 20 20 30 20 30 20 31 30 30 31 30 20 20 20 20 20 20 20 20 20 30 20 31 20 31 30 30 30 31 30 31 30 30 31 31 20 30 20 20 20 31 20 31 20 20 20 20 20 20 20 20 20 30 20 31 20 20 20 20 20 30 30 30 30 30 30 30 30
30 30 30 30 30 30 30 20 20 31 20 30 20 31 20 20 20 20 20 31 30 30 31 31 30 30 31 31 20 31 20 31 20 20 20 20 20 20 20 20 20 31 20 31 20 30 20 30 20 30 30 30 31 31 30 30 31 30 20 30 20 30 30 31 31 20 20 30 30 30 30 30 30 30 30
30 30 30 30 30 30 30 20 20 30 20 31 20 31 20 30 31 30 30 31 20 20 20 20 20 20 20 20 20 30 20 31 20 30 30 31 31 30 30 31 20 31 20 30 20 31 20 30 20 20 20 20 20 20 20 20 20 31 20 30 20 20 20 20 30 20 20 30 30 30 30 30 30 30 30
30 30 30 30 30 30 30 20 20 30 30 31 20 30 20 20 20 20 31 20 20 31 30 30 31 31 30 30 31 30 20 30 20 31 20 20 20 20 20 20 20 30 20 30 20 31 20 30 20 31 31 30 30 31 31 30 30 31 20 31 31 30 30 20 30 20 20 30 30 30 30 30 30 30 30
30 30 30 30 30 30 30 20 30 31 20 20 20 30 30 31 31 20 30 20 30 30 20 20 31 20 20 20 20 20 20 30 20 30 20 20 20 31 30 30 31 30 20 31 20 30 20 31 20 30 20 20 20 20 20 20 20 20 20 20 20 20 30 20 31 20 20 30 30 30 30 30 30 30 30
30 30 30 30 30 30 30 20 20 31 20 20 20 20 20 20 30 20 30 20 31 20 20 20 30 20 31 31 30 30 31 31 20 31 30 31 20 31 20 20 20 20 20 31 20 30 20 30 20 30 31 30 31 30 30 31 30 30 31 31 30 30 31 20 30 20 20 30 30 30 30 30 30 30 30
30 30 30 30 30 30 30 20 31 30 30 31 31 31 30 20 30 20 31 20 30 30 30 20 31 20 30 20 20 20 20 20 20 20 20 31 20 30 31 30 30 31 30 30 20 31 20 30 20 20 20 20 20 20 20 20 31 20 20 20 20 20 31 20 30 31 20 30 30 30 30 30 30 30 30
30 30 30 30 30 30 30 20 31 20 30 20 20 30 20 20 31 20 31 20 20 20 31 20 30 20 31 30 30 31 30 31 30 31 20 30 20 30 20 20 20 20 20 30 20 30 20 30 20 30 30 30 31 31 30 30 31 20 30 20 20 20 20 20 20 30 20 30 30 30 30 30 30 30 30
30 30 30 30 30 30 30 20 30 20 31 20 20 31 30 30 31 20 30 30 31 30 31 20 30 20 20 20 20 20 20 30 20 31 20 30 20 31 20 30 31 31 20 31 20 30 20 31 20 31 20 20 20 20 20 20 20 20 31 31 30 30 31 30 30 31 20 30 30 30 30 30 30 30 30
30 30 30 30 30 30 30 20 30 20 30 20 20 20 20 20 30 20 20 20 20 20 20 20 31 20 20 20 20 20 20 31 20 30 20 30 20 30 31 30 20 30 20 31 20 31 30 31 20 31 30 30 31 30 30 31 30 20 31 20 31 20 20 20 20 20 20 30 30 30 30 30 30 30 30
30 30 30 30 30 30 30 20 31 20 30 20 30 31 31 30 30 20 31 30 30 31 31 20 31 30 30 30 31 31 20 30 20 30 20 31 20 20 20 20 20 30 20 30 20 20 20 20 20 20 20 20 20 20 20 20 20 20 30 20 30 20 30 31 30 30 20 30 30 30 30 30 30 30 30
30 30 30 30 30 30 30 20 20 20 31 20 31 20 20 20 31 20 31 20 20 20 30 20 20 20 20 20 20 31 20 30 20 30 20 31 30 30 31 31 20 30 20 30 20 31 31 30 30 31 31 30 30 30 31 31 20 30 30 20 31 20 30 20 20 20 20 30 30 30 30 30 30 30 30
30 30 30 30 30 30 30 20 20 30 31 20 31 20 20 30 30 20 30 31 31 20 30 20 30 30 31 30 30 30 20 31 20 31 20 20 20 20 20 30 20 30 20 30 20 31 20 20 20 20 20 20 20 20 20 30 20 31 20 20 30 20 31 30 30 31 20 30 30 30 30 30 30 30 30
30 30 30 30 30 30 30 20 20 31 20 20 30 30 20 31 20 20 20 20 30 20 31 20 31 20 20 20 20 20 20 31 30 31 31 30 30 31 20 30 20 31 20 30 20 30 20 31 30 31 30 30 31 20 30 30 20 30 31 20 30 20 20 20 20 30 20 30 30 30 30 30 30 30 30
30 30 30 30 30 30 30 20 20 30 20 20 20 31 20 30 31 30 30 20 30 20 31 20 31 30 31 30 30 30 20 20 20 20 20 20 20 30 20 31 20 31 20 31 20 30 20 30 20 20 20 20 31 20 31 20 20 20 30 20 31 31 30 30 31 31 20 30 30 30 30 30 30 30 30
30 30 30 30 30 30 30 20 31 30 31 31 20 31 20 20 20 20 31 20 31 20 30 20 30 20 20 20 20 31 20 30 31 31 30 30 31 31 30 30 20 30 20 31 20 31 20 30 20 31 30 31 30 20 31 20 30 20 31 20 20 20 20 20 20 20 20 30 30 30 30 30 30 30 30
30 30 30 30 30 30 30 20 31 20 20 30 20 30 20 31 30 30 31 20 30 20 30 20 30 31 30 31 20 31 20 20 20 20 20 20 20 31 20 20 20 20 20 30 20 31 20 20 20 31 20 31 20 20 30 30 31 20 30 31 30 30 31 30 30 30 20 30 30 30 30 30 30 30 30
30 30 30 30 30 30 30 20 30 31 20 30 20 31 20 30 20 20 20 20 30 20 30 20 20 20 20 20 20 30 20 31 30 30 31 31 30 30 20 30 31 31 30 30 20 30 30 31 20 30 20 30 20 20 30 20 20 20 20 20 20 20 20 20 20 31 20 30 30 30 30 30 30 30 30
30 30 30 30 30 30 30 20 20 20 20 30 20 30 20 30 31 30 30 31 31 20 31 20 30 30 31 31 30 30 20 31 20 20 20 20 20 20 20 20 20 20 20 20 20 20 20 30 20 30 20 30 20 20 31 20 30 31 30 31 30 31 31 30 30 31 20 30 30 30 30 30 30 30 30
30 30 30 30 30 30 30 20 30 31 20 31 20 31 20 20 20 20 20 20 20 20 31 20 30 20 20 20 20 20 20 30 20 30 31 31 30 31 30 20 31 30 30 30 31 31 20 31 30 31 20 31 30 20 31 20 31 20 30 20 20 20 20 20 20 20 20 30 30 30 30 30 30 30 30
30 30 30 30 30 30 30 20 20 31 20 31 20 31 20 31 31 30 30 31 30 31 30 20 31 20 30 31 30 30 31 30 20 30 20 30 20 20 20 20 31 20 20 20 20 30 20 20 20 20 20 20 20 20 30 20 30 20 31 31 30 31 30 30 31 30 20 30 30 30 30 30 30 30 30
30 30 30 30 30 30 30 20 30 30 20 30 20 30 20 30 20 20 20 20 20 20 30 20 31 20 30 20 20 20 20 20 20 31 20 30 20 30 30 31 30 20 31 30 31 30 30 31 30 31 30 30 31 30 31 20 30 20 30 20 20 20 20 20 20 31 20 30 30 30 30 30 30 30 30
30 30 30 30 30 30 30 20 30 20 20 30 20 30 20 30 20 31 30 30 30 31 31 20 30 20 31 20 30 30 31 31 30 30 20 31 20 31 20 31 20 20 30 20 30 20 20 30 20 20 20 20 20 20 20 20 31 20 30 20 31 30 30 31 30 30 20 30 30 30 30 30 30 30 30
30 30 30 30 30 30 30 20 31 31 30 31 20 30 20 31 20 31 20 20 20 20 20 20 30 20 30 20 31 20 20 31 20 20 20 30 20 31 20 30 20 31 30 20 30 20 31 31 30 30 30 20 30 31 30 30 31 20 31 20 30 20 20 20 20 20 20 30 30 30 30 30 30 30 30
30 30 30 30 30 30 30 20 20 20 20 20 20 31 20 31 20 30 30 30 20 31 30 31 31 20 31 30 30 30 20 30 20 31 30 30 31 30 20 30 20 31 20 20 30 20 30 20 20 20 20 20 31 20 20 20 20 20 31 20 31 30 30 31 30 31 20 30 30 30 30 30 30 30 30
30 30 30 30 30 30 30 20 30 30 31 30 31 31 20 30 20 30 20 20 20 30 20 30 20 20 20 20 20 30 20 30 20 30 20 20 30 20 20 30 20 30 20 20 31 20 30 30 30 30 30 20 30 20 31 30 31 30 30 20 20 20 20 20 20 30 20 30 30 30 30 30 30 30 30
30 30 30 30 30 30 30 20 31 20 30 20 20 30 20 30 20 31 31 30 30 31 20 30 20 31 31 30 30 31 20 31 20 30 20 20 31 31 20 31 20 30 20 30 31 20 31 20 20 20 20 20 30 20 31 20 20 20 20 20 31 30 30 31 31 30 20 30 30 30 30 30 30 30 30
30 30 30 30 30 30 30 20 31 20 30 20 31 30 20 30 20 20 20 20 20 20 20 31 20 30 20 20 20 20 20 31 20 31 20 20 20 30 20 31 20 30 20 30 20 20 30 31 30 31 31 20 31 20 30 30 31 31 30 20 30 20 20 20 20 20 20 30 30 30 30 30 30 30 30
30 30 30 30 30 30 30 20 30 20 30 20 30 20 20 31 20 20 31 31 30 30 31 30 20 30 31 30 30 30 20 30 20 30 31 30 20 30 20 30 20 31 20 31 20 20 20 20 20 20 30 20 31 20 20 20 20 20 31 20 31 20 30 31 30 20 20 30 30 30 30 30 30 30 30
30 30 30 30 30 30 30 20 30 20 31 20 30 20 30 30 31 30 30 20 20 20 30 20 20 20 20 20 20 31 20 20 20 20 30 20 20 30 20 30 20 31 20 30 31 31 31 30 30 31 30 20 30 20 30 31 31 30 30 20 30 20 30 20 30 20 20 30 30 30 30 30 30 30 30
30 30 30 30 30 30 30 20 20 20 31 20 31 20 20 31 20 20 30 20 20 20 31 20 31 31 30 30 20 30 31 30 31 20 30 20 20 31 20 31 20 30 20 20 30 20 30 20 31 20 31 20 30 20 30 20 20 20 20 20 30 20 31 20 31 20 20 30 30 30 30 30 30 30 30
30 30 30 30 30 30 30 20 31 30 30 20 31 30 20 31 20 20 31 31 30 20 30 20 30 20 20 31 20 20 31 20 30 20 31 30 30 31 20 30 31 30 31 31 30 20 31 20 30 30 31 20 30 20 31 20 31 31 31 20 31 20 31 20 31 20 20 30 30 30 30 30 30 30 30
30 30 30 30 30 30 30 20 20 20 20 20 20 30 20 30 20 20 20 20 30 20 30 20 30 20 20 30 20 20 30 20 30 20 20 20 20 20 20 20 20 20 20 20 20 20 20 20 20 20 20 20 31 20 31 20 30 20 30 20 30 20 30 20 30 20 20 30 30 30 30 30 30 30 30
30 30 30 30 30 30 30 20 31 30 30 30 20 31 20 30 31 31 30 20 31 20 31 20 31 31 20 31 30 31 30 20 31 31 30 30 30 31 31 30 30 30 31 31 30 30 31 30 31 31 30 30 31 20 30 20 31 20 31 20 31 20 20 20 30 20 20 30 30 30 30 30 30 30 30
30 30 30 30 30 30 30 20 30 20 30 20 20 31 20 20 20 20 30 20 30 20 31 20 20 30 20 20 20 20 20 20 20 20 20 20 20 20 20 20 20 20 20 20 30 20 31 20 20 20 20 20 20 20 30 20 30 20 30 20 30 31 30 30 31 20 20 30 30 30 30 30 30 30 30
30 30 30 30 30 30 30 20 30 20 20 20 20 31 30 30 20 20 31 20 30 20 30 30 31 30 20 31 30 31 30 30 31 31 30 30 31 20 30 30 31 20 31 20 31 20 30 20 30 20 31 31 30 20 31 20 30 20 30 20 20 20 20 20 20 20 20 30 30 30 30 30 30 30 30
30 30 30 30 30 30 30 20 31 30 31 30 30 31 20 31 20 20 30 20 31 20 20 20 20 30 20 31 20 20 20 20 20 20 20 20 31 20 30 20 31 20 30 20 30 20 30 20 30 20 30 20 30 20 30 20 30 20 31 30 31 30 30 31 31 30 20 30 30 30 30 30 30 30 30
30 30 30 30 30 30 30 20 31 20 20 20 20 20 20 31 30 30 31 20 30 30 31 31 20 31 20 30 31 30 30 31 31 30 30 20 30 20 31 20 30 20 30 31 31 20 31 31 30 20 31 20 31 20 31 20 31 20 20 20 20 20 20 30 20 20 20 30 30 30 30 30 30 30 30
30 30 30 30 30 30 30 20 30 31 30 30 31 20 20 20 20 20 20 20 20 20 20 30 20 31 20 20 20 20 20 20 20 20 30 20 30 20 31 20 30 20 20 20 20 20 20 20 20 20 30 20 31 30 30 20 31 30 31 30 30 31 20 30 20 31 20 30 30 30 30 30 30 30 30
30 30 30 30 30 30 30 20 31 20 20 20 30 20 31 30 30 31 20 31 31 30 20 31 20 30 20 20 20 20 30 31 31 20 31 20 30 20 30 20 31 30 30 31 30 31 30 30 31 31 30 20 20 20 20 20 20 20 20 20 20 31 20 31 20 31 20 30 30 30 30 30 30 30 30
30 30 30 30 30 30 30 20 20 20 20 20 20 20 30 20 20 31 20 30 20 31 20 30 20 30 31 31 30 20 30 20 30 20 31 20 31 20 31 20 20 20 20 20 20 20 20 20 20 20 20 20 20 20 20 31 31 30 30 31 20 30 20 30 20 30 20 30 30 30 30 30 30 30 30
30 30 30 30 30 30 30 20 31 30 30 30 30 31 31 20 30 30 20 31 20 30 20 20 20 20 30 20 30 20 31 20 30 20 30 20 31 20 30 31 30 30 31 20 30 31 30 20 31 30 30 31 31 30 20 30 20 20 20 31 20 30 20 31 20 30 20 30 30 30 30 30 30 30 30
30 30 30 30 30 30 30 20 30 30 31 31 30 30 31 20 31 20 20 30 20 30 31 30 30 20 31 30 31 20 30 20 30 20 30 20 30 20 20 20 20 20 30 20 31 20 31 20 31 20 20 20 20 30 20 30 20 20 20 30 20 31 20 30 20 30 20 30 30 30 30 30 30 30 30
30 30 30 30 30 30 30 20 31 30 30 30 30 30 30 20 30 20 20 30 20 20 31 20 30 20 20 20 20 20 30 20 31 20 31 20 30 31 30 30 31 20 30 20 30 20 31 20 30 31 30 31 20 31 31 30 30 31 20 30 20 31 20 30 20 31 20 30 30 30 30 30 30 30 30
30 30 30 30 30 30 30 20 30 31 30 30 31 30 30 20 31 30 30 31 20 20 30 30 31 31 30 30 30 31 31 20 30 31 30 20 20 20 20 20 31 30 31 30 31 20 30 31 30 20 20 20 20 20 20 20 20 31 20 31 30 30 20 31 30 31 20 30 30 30 30 30 30 30 30
30 30 30 30 30 30 30 20 20 20 20 20 20 20 20 20 20 20 20 20 20 20 20 20 20 20 20 20 20 20 20 20 20 20 20 20 20 20 20 20 20 20 20 20 20 20 20 20 20 20 20 20 20 20 20 20 20 20 20 20 20 20 20 20 20 20 20 30 30 30 30 30 30 30 30
30 30 30 30 30 30 30 30 30 30 30 30 30 30 30 30 30 30 30 30 30 30 30 30 30 30 30 30 30 30 30 30 30 30 30 30 30 30 30 30 30 30 30 30 30 30 30 30 30 30 30 30 30 30 30 30 30 30 30 30 30 30 30 30 30 30 30 30 30 30 30 30 30 30 30
30 30 30 30 30 30 30 30 30 30 30 30 30 30 30 30 30 30 30 30 30 30 30 30 30 30 30 30 30 30 30 30 30 30 30 30 30 30 30 30 30 30 30 30 30 30 30 30 30 30 30 30 30 30 30 30 30 30 30 30 30 30 30 30 30 30 30 30 30 30 30 30 30 30 30
30 30 30 30 30 30 30 30 30 30 30 30 30 30 30 30 30 30 30 30 30 30 30 30 30 30 30 30 30 30 30 30 30 30 30 30 30 30 30 30 30 30 30 30 30 30 30 30 30 30 30 30 30 30 30 30 30 30 30 30 30 30 30 30 30 30 30 30 30 30 30 30 30 30 30
30 30 30 30 30 30 30 30 30 30 30 30 30 30 30 30 30 30 30 30 30 30 30 30 30 30 30 30 30 30 30 30 30 30 30 30 30 30 30 30 30 30 30 30 30 30 30 30 30 30 30 30 30 30 30 30 30 30 30 30 30 30 30 30 30 30 30 30 30 30 30 30 30 30 30
30 30 30 30 30 30 30 30 30 30 30 30 30 30 30 30 30 30 30 30 30 30 30 30 30 30 30 30 30 30 30 30 30 30 30 30 30 30 30 30 30 30 30 30 30 30 30 30 30 30 30 30 30 30 30 30 30 30 30 30 30 30 30 30 30 30 30 30 30 30 30 30 30 30 30
30 30 30 30 30 30 30 30 30 30 30 30 30 30 30 30 30 30 30 30 30 30 30 30 30 30 30 30 30 30 30 30 30 30 30 30 30 30 30 30 30 30 30 30 30 30 30 30 30 30 30 30 30 30 30 30 30 30 30 30 30 30 30 30 30 30 30 30 30 30 30 30 30 30 30
30 30 30 30 30 30 30 30 30 30 30 30 30 30 30 30 30 30 30 30 30 30 30 30 30 30 30 30 30 30 30 30 30 30 30 30 30 30 30 30 30 30 30 30 30 30 30 30 30 30 30 30 30 30 30 30 30 30 30 30 30 30 30 30 30 30 30 30 30 30 30 30 30 30 30