20 20 20 20 20 20 20 20 20 20 20 20 20 20 20 20 20 20 20 20 20 20 20 20 20 20 20 20 20 20 20 20 20 20 20 20 20 20 20 20 20 20 20 20 20 20 20 20 20 20
20 20 20 20 20 20 20 20 20 20 20 20 20 20 20 20 20 20 20 20 20 20 20 20 20 20 20 20 20 20 20 20 20 20 20 20 20 20 20 20 20 20 20 20 20 20 20 20 20 20
20 20 20 20 20 20 20 20 20 20 20 20 20 20 20 20 20 20 20 20 20 20 20 20 20 20 20 20 20 20 20 20 20 20 20 20 20 20 20 20 20 20 20 20 20 20 20 20 20 20
20 20 20 20 20 20 20 20 20 20 20 20 20 20 20 20 20 20 20 20 20 20 20 20 20 20 20 20 20 20 20 20 20 20 20 20 20 20 20 20 20 20 20 20 20 20 20 20 20 20
20 20 20 20 20 20 20 20 20 20 20 20 20 20 20 20 20 20 20 20 20 20 20 20 20 20 20 20 20 20 20 20 20 20 20 20 20 20 20 20 20 20 20 20 20 20 20 20 20 20
20 20 20 20 20 20 20 20 20 20 20 20 20 20 20 20 20 20 20 20 20 20 20 20 20 20 20 20 20 20 20 20 20 20 20 20 20 20 20 20 20 20 20 20 20 20 20 20 20 20
20 20 20 20 20 20 20 20 20 20 20 20 20 20 20 20 20 20 20 20 20 20 20 20 20 20 20 20 20 20 20 20 20 20 20 20 20 20 20 20 20 20 20 20 20 20 20 20 20 20
20 20 20 20 20 20 20 20 20 30 30 30 30 30 30 20 20 20 20 20 20 20 20 20 30 30 30 30 30 30 20 20 20 20 20 20 20 20 20 20 20 20 20 20 20 20 20 20 20 20
20 20 20 20 20 20 20 20 30 11 12 12 12 12 13 30 20 20 20 20 20 20 30 30 11 12 12 12 12 13 30 20 20 20 20 20 20 20 20 20 20 20 20 20 20 20 20 20 20 20
20 20 20 20 20 20 20 20 30 14 15 15 15 15 16 30 30 30 30 30 30 30 11 12 39 15 15 15 15 38 13 30 20 20 20 20 20 20 20 20 20 20 20 20 20 20 20 20 20 20
20 20 20 20 20 20 20 20 30 14 15 15 15 15 38 12 12 12 12 12 12 12 39 15 15 15 15 15 15 15 38 12 12 12 12 12 12 12 13 20 20 20 20 20 20 20 20 20 20 20
20 20 20 20 20 20 20 20 30 14 15 15 15 15 36 18 18 18 18 18 18 18 37 15 15 15 15 15 15 15 15 36 18 18 18 18 37 15 38 13 20 20 20 20 20 20 20 20 20 20
20 20 20 20 20 20 20 20 30 14 15 15 15 15 16 30 30 30 30 30 30 30 14 15 15 15 15 15 15 15 15 16 20 20 20 20 17 37 15 16 20 20 20 20 20 20 20 20 20 20
20 20 20 20 20 20 20 20 30 17 18 18 18 18 19 30 20 20 20 20 20 30 14 15 15 15 15 15 15 15 15 16 20 20 20 20 20 17 37 16 20 20 20 20 20 20 20 20 20 20
20 20 20 20 20 20 20 20 30 30 30 30 30 30 30 20 20 20 20 20 20 30 17 37 15 15 15 15 15 15 36 19 20 20 20 20 20 20 14 16 20 20 20 20 20 20 20 20 20 20
20 20 20 20 20 20 20 20 20 20 20 20 20 20 20 20 20 20 20 20 20 20 30 17 37 15 15 15 15 36 19 30 20 20 20 20 20 20 14 16 20 20 20 20 20 20 20 20 20 20
20 20 20 20 20 20 20 20 20 20 20 20 20 20 20 20 20 20 20 20 20 20 20 30 17 18 18 18 18 19 30 30 20 20 20 20 20 20 14 16 20 20 20 20 20 20 20 20 20 20
20 20 20 20 20 20 20 20 20 20 20 20 20 20 20 20 20 20 20 20 20 20 20 20 30 30 30 30 30 30 20 20 20 20 20 20 20 20 14 16 20 20 20 20 20 20 20 20 20 20
20 20 20 20 20 20 20 20 20 20 20 20 20 20 20 20 20 20 20 20 20 20 20 20 20 20 20 20 20 20 20 20 20 20 20 20 20 20 14 16 20 20 20 20 20 20 20 20 20 20
20 20 20 20 20 20 20 20 20 20 20 20 20 20 20 20 20 20 20 20 20 20 20 20 20 20 20 20 20 20 20 20 20 20 20 11 12 12 39 16 20 20 20 20 20 20 20 20 20 20
20 20 20 20 20 20 20 20 20 20 20 20 20 20 20 20 20 20 20 20 20 20 20 20 20 20 20 20 20 20 20 20 20 20 11 39 15 15 15 38 13 20 20 20 20 20 20 20 20 20
20 20 20 20 20 20 20 20 20 20 20 20 20 20 20 20 20 20 20 20 20 20 20 20 20 20 20 20 20 20 20 20 20 11 39 15 15 15 15 15 16 20 20 20 20 20 20 20 20 20
20 20 20 20 20 20 20 20 20 20 20 20 20 20 20 20 20 20 20 20 20 20 20 20 20 20 20 20 20 20 20 20 20 14 15 15 15 15 15 15 16 20 20 20 20 20 20 20 20 20
20 20 20 20 20 20 20 20 20 20 20 20 20 20 20 20 20 20 20 20 20 20 20 20 20 20 20 20 20 20 20 20 20 14 15 15 15 15 15 15 16 20 20 20 20 20 20 20 20 20
20 20 20 20 20 20 20 20 20 20 20 20 20 20 20 20 20 20 20 20 20 20 20 20 20 20 20 20 20 20 20 20 20 14 15 15 15 15 15 15 16 20 20 20 20 20 20 20 20 20
20 20 20 20 20 20 20 20 20 20 20 20 20 20 20 20 20 20 20 20 20 20 20 20 20 20 20 20 20 20 20 20 20 17 37 15 15 15 15 36 19 20 20 20 20 20 20 20 20 20
20 20 20 20 20 20 20 20 20 20 20 20 20 20 20 20 20 20 20 20 20 20 20 20 20 20 20 20 20 20 20 20 20 20 17 18 37 15 36 19 20 20 20 20 20 20 20 20 20 20
20 20 20 20 20 20 20 20 20 20 20 20 20 20 20 20 20 20 20 20 20 20 20 20 20 20 20 20 20 20 20 20 20 20 20 20 14 36 19 20 20 20 20 20 20 20 20 20 20 20
20 20 20 20 20 20 20 20 20 20 20 20 11 12 12 12 12 12 12 12 13 20 20 20 20 20 20 20 20 20 20 20 20 20 20 20 14 16 20 20 20 20 20 20 20 20 20 20 20 20
20 20 20 20 20 20 20 20 20 20 11 12 39 15 15 15 15 15 15 15 38 13 20 20 20 20 20 20 20 20 20 20 20 20 20 20 14 16 20 20 20 20 20 20 20 20 20 20 20 20
20 20 20 20 20 20 20 20 20 11 39 15 15 15 15 15 15 15 15 15 15 38 13 20 20 20 20 20 20 20 20 20 20 20 20 20 14 16 20 20 20 20 20 20 20 20 20 20 20 20
20 20 20 20 20 20 20 20 20 14 15 15 15 15 15 15 15 15 15 15 15 15 16 20 20 20 20 20 20 20 20 20 20 20 11 12 39 38 13 20 20 20 20 20 20 20 20 20 20 20
20 20 20 20 20 20 20 20 20 14 15 15 15 15 15 15 15 15 15 15 15 15 16 20 20 20 20 20 20 20 20 20 20 11 39 15 15 15 38 13 20 20 20 20 20 20 20 20 20 20
20 20 20 20 20 20 20 20 20 14 15 15 15 15 15 15 15 15 15 15 15 15 16 20 20 20 20 20 20 20 20 20 20 14 15 15 15 15 15 38 13 20 20 20 20 20 20 20 20 20
20 20 20 20 20 20 20 20 20 14 15 15 15 15 15 15 15 15 15 15 15 15 38 12 12 12 12 12 12 12 12 12 12 39 15 15 15 15 15 15 16 20 20 20 20 20 20 20 20 20
20 20 20 20 20 20 20 20 20 14 15 15 15 15 15 15 15 15 15 15 15 15 36 18 18 18 18 18 18 18 18 18 37 15 15 15 15 15 15 15 16 20 20 20 20 20 20 20 20 20
20 20 20 20 20 20 20 20 20 14 15 15 15 15 15 15 15 15 15 15 15 15 16 20 20 20 20 20 20 20 20 20 14 15 15 15 15 15 15 15 16 20 20 20 20 20 20 20 20 20
20 20 20 20 20 20 20 20 20 17 37 15 15 15 15 15 15 15 15 15 15 36 19 20 20 20 20 20 20 20 20 20 17 37 15 15 15 15 15 15 16 20 20 20 20 20 20 20 20 20
20 20 20 20 20 20 20 20 20 20 17 18 37 15 15 15 15 15 15 36 18 19 30 20 20 20 20 20 20 20 20 20 20 17 37 15 15 15 15 36 19 20 20 20 20 20 20 20 20 20
20 20 20 20 20 20 20 20 20 20 20 20 17 18 18 18 18 18 18 19 30 20 20 20 20 20 20 20 20 20 20 20 20 20 17 18 18 18 18 19 20 20 20 20 20 20 20 20 20 20
20 20 20 20 20 20 20 20 20 20 20 20 20 20 20 20 20 20 20 20 20 20 20 20 20 20 20 20 20 20 20 20 20 20 20 20 20 20 20 20 20 20 20 20 20 20 20 20 20 20
20 20 20 20 20 20 20 20 20 20 20 20 20 20 20 20 20 20 20 20 20 20 20 20 20 20 20 20 20 20 20 20 20 20 20 20 20 20 20 20 20 20 20 20 20 20 20 20 20 20
20 20 20 20 20 20 20 20 20 20 20 20 20 20 20 20 20 20 20 20 20 20 20 20 20 20 20 20 20 20 20 20 20 20 20 20 20 20 20 20 20 20 20 20 20 20 20 20 20 20
20 20 20 20 20 20 20 20 20 20 20 20 20 20 20 20 20 20 20 20 20 20 20 20 20 20 20 20 20 20 20 20 20 20 20 20 20 20 20 20 20 20 20 20 20 20 20 20 20 20
20 20 20 20 20 20 20 20 20 20 20 20 20 20 20 20 20 20 20 20 20 20 20 20 20 20 20 20 20 20 20 20 20 20 20 20 20 20 20 20 20 20 20 20 20 20 20 20 20 20
20 20 20 20 20 20 20 20 20 20 20 20 20 20 20 20 20 20 20 20 20 20 20 20 20 20 20 20 20 20 20 20 20 20 20 20 20 20 20 20 20 20 20 20 20 20 20 20 20 20
20 20 20 20 20 20 20 20 20 20 20 20 20 20 20 20 20 20 20 20 20 20 20 20 20 20 20 20 20 20 20 20 20 20 20 20 20 20 20 20 20 20 20 20 20 20 20 20 20 20
20 20 20 20 20 20 20 20 20 20 20 20 20 20 20 20 20 20 20 20 20 20 20 20 20 20 20 20 20 20 20 20 20 20 20 20 20 20 20 20 20 20 20 20 20 20 20 20 20 20
20 20 20 20 20 20 20 20 20 20 20 20 20 20 20 20 20 20 20 20 20 20 20 20 20 20 20 20 20 20 20 20 20 20 20 20 20 20 20 20 20 20 20 20 20 20 20 20 20 20
20 20 20 20 20 20 20 20 20 20 20 20 20 20 20 20 20 20 20 20 20 20 20 20 20 20 20 20 20 20 20 20 20 20 20 20 20 20 20 20 20 20 20 20 20 20 20 20 20 20